new col
1110010110 
0000000001 
0000000001 
0000000000 
0000000011 
0000000001 
0000000000 
0000000000 
new col
1110011010 
0000000000 
1111111101 
0000000000 
0000000011 
0000000010 
0000000001 
1111111101 
new col
1110011010 
1111111111 
1111111100 
1111111111 
1111111110 
1111111111 
0000000000 
0000000000 
new col
1110010101 
0000000011 
1111111110 
0000000000 
1111111011 
1111111110 
0000000011 
0000000011 
new col
1110010111 
0000000001 
1111111101 
1111111110 
1111111110 
0000000010 
1111111110 
0000000000 
new col
1110011011 
1111111110 
0000000001 
1111111111 
0000000000 
0000000010 
1111111101 
1111111111 
new col
1110011010 
0000000000 
0000000001 
0000000010 
0000000001 
1111111100 
0000000011 
1111111111 
new col
1110011010 
0000000101 
0000000000 
1111111111 
0000000001 
1111111111 
0000000000 
1111111111 
